11111
10E01
10001
10C01
11111
