1E11111
10000P1
1C00001
1111111
