1111111
1E00EE1
1101111
1C00011
1CCPCC1
1111111
