1111111111
1E00000011
1CCCC00001
1111111001
1P00000011
1111111111