1111111111
1E1C0001P1
1011010101
1000010001
11110101C1
11C0000001
1111111111
